## ###
### ##
#### #
## ###
### ##
end
